11111111111111111111111111111111111
1E0000000000000C00000C0000000000001
10100101001000001010010000000010101
10100100101010100010010000010010101
1P0000000C00C00000000000000010000C1
11111111111111111111111111111111111
