1111111111111111111111111
100000000000000C000000001
1010010100100000100010101
1010010010101010010010101
110000000000000C000000001
1010010100100000100010101
101001001010E010010010101
110000111100000C000000001
1010010100100000100010101
1000010010101010010010101
1P1000000C00C0010010000C1
1111111111111111111111111
